1111111111111111111111111
1000100000000000000000001
1000100000000000000000001
1000100000000000000000001
1000100000000000000000001
1000100000000000000000001
1000100000000000000000001
1000100000000000000000001
1000000000000000000000001
1000000000000000000000001
1000000000000000000000001
1000000000000000000000001
1000000000000011111111111
1000000000000000000000001
1111111011101111111111111
1000000000000000000000001
1000000000000000000000001
1000000000000000000000001
1000000000000000000000001
1000000000000000000000001
1000000000000000000000001
1000000000000000000000001
1111111110000000000000001
1000000000000000000000001
1111111111111111111111111
