//ID
0000000018
//NOM
niveau1
//MAP
1111111111111111111111111
1000000000000000000000001
1011111111111111111111111
1000000000000000000000001
1111111111111111111111101
1000010000000000000000001
1011111111111111111111111
1000000000000000000000001
1111111111111111111111101
1000000000000000000000001
1000000000000000000000001
1000000000110110000000001
1000000000100010000000001
1000000000111110000000001
1111111000000000111111111
1000000000000000000000001
1000000000000000000000001
1000000000000000000000001
1000000000000000000000001
1000000000000000000000001
1000000000000000000000001
1000000000000000000000001
1111111110000000000000001
1000000000000000001100001
1111111111111111111111111
//SCORE
1524
//TEMPS
18
